0,0,0,0,0,0,0,0,0,0,0,0
0,0,6,5,10,0,0,5,5,10,5,0
0,3,1,1,1,5,0,5,1,1,2,0
0,0,6,6,1,5,5,6,1,5,5,0
0,0,0,5,1,1,1,1,1,5,0,0
0,0,0,0,5,5,5,5,6,0,0,0
0,0,0,0,0,0,0,0,0,0,0,0
0,0,0,0,0,0,0,0,0,0,0,0
