0,0,10,0,0,0,6,10,6,0,0,0
0,3,1,5,6,10,1,1,1,5,0,0
0,5,1,6,1,1,1,5,1,10,0,0
0,6,1,5,1,6,5,6,1,1,6,0
0,6,1,10,1,5,0,6,5,1,5,0
0,5,1,1,1,5,0,0,6,1,5,0
0,6,6,5,6,5,0,0,5,1,2,0
0,0,0,0,0,0,0,0,5,5,5,0
