0,0,0,0,0,0,0,0,0,0,0,0
0,0,0,0,0,0,0,0,0,5,6,0
0,0,5,6,5,0,0,6,5,1,2,0
0,3,1,1,1,5,5,1,1,1,6,0
0,0,5,6,1,5,6,1,6,5,0,0
0,0,0,6,1,1,1,1,5,0,0,0
0,0,0,0,6,5,5,6,0,0,0,0
0,0,0,0,0,0,0,0,0,0,0,0
