0,0,0,0,0,0,0,0,0,0,0,0
0,0,6,10,5,0,0,0,0,0,0,0
0,5,1,1,1,6,0,0,5,5,6,0
0,5,1,6,1,5,0,5,1,1,2,0
0,3,1,6,1,10,6,6,1,5,5,0
0,0,5,6,1,1,1,6,1,5,0,0
0,0,0,0,5,5,1,1,1,6,0,0
0,0,0,0,0,0,5,5,5,0,0,0
