0,0,0,0,0,0,0,0,0,0,0,0
0,5,10,5,10,0,0,6,5,10,0,0
5,1,1,1,1,0,6,1,1,1,5,0
0,3,5,5,1,10,1,1,5,1,2,0
0,0,0,6,1,1,1,5,6,5,5,0
0,0,0,0,6,5,6,0,0,0,0,0
0,0,0,0,0,0,0,0,0,0,0,0
0,0,0,0,0,0,0,0,0,0,0,0
